########################################################
#------------------------------------------------------#
#------------------------------------------------------#
#------------------------------------------------------#
#------------------------------------------------------#
#------------------------------------------------------#
#------------------------------------------------------#
#------------------------------------------------------#
#------------------------------------------------------#
#------------------------------------------------------#
#------------------------------------------------------#
#----------Dysphoria-----------------------------------#
#---------*--------------------------------------------#
#------------------------------------------------------#
#------------------------------------------------------#
#------------------------------------------------------#
#------------------------------------------------------#
#------------------------------------------------------#
#------------------------------------------------------#
#------------------------------------------------------#
#------------------------------------------------------#
#------------------------------------------------------#
#------------------------------------------------------#
########################################################