################################################################
#                              Key                             #
# ~~~  .............................................     Water #
# YYY  .............................................     Trees #
# ...  .............................................      Road #
# ===  .............................................    Bridge #
#  *   .............................................  Location #
#                                                              #
################################################################