####################################################### 
#                         Key                         # 
# ~~~  ....................................     Water # 
# ...  ....................................      Road # 
# ===  ....................................    Bridge # 
#  *   ....................................  Location # 
#                                                     # 
#######################################################