#######################################################
#-----------------------------------------------------#
#-----------------------------------------------------#
#-----------------------------------------------------#
#-----------------------------------------------------#
#-----------------------------------------------------#
#-----------------------------------------------------#
#-----------------------------------------------------#
#-----------------------------------------------------#
#-----------------------------------------------------#
#-----------------------------------------------------#
#----------Dysphoria----------------------------------#
#---------*-------------------------------------------#
#-----------------------------------------------------#
#-----------------------------------------------------#
#-----------------------------------------------------#
#-----------------------------------------------------#
#-----------------------------------------------------#
#-----------------------------------------------------#
#-----------------------------------------------------#
#-----------------------------------------------------#
#-----------------------------------------------------#
#-----------------------------------------------------#
#######################################################