#######################################################
#------------------------------------------------~----#
#-----------------------------------------------~-----#
#---------------------------------------------~-------#
#--------------------------------------------~--------#
#-----------------------------------------~-----------#
#--------------------------------------~--------------#
#-----------------------------------~-----------------#
#----------------------------------~------------------#
#----------------------------------~------------------#
#----------------------------------~------------------#
#---------------------------------~-------------------#
#-------------------------------~---------------------#
#-----------------------------~-----------------------#
#---------------Dysphoria----~------------------------#
#------------------------*.=.-------------------------#
#------------------------~---.------------------------#
#----------------------~-------.----------------------#
#-------------------~-------------.-.-----------------#
#-------------~-~-~--------------------.--------------#
#-----------~-----------------------------.-Watchtower#
#----------~--------------------------------*---------#
#--------~--------------------------------------------#
#######################################################